NO ./ruins/Tileable1k.xpm
SO ./ruins/Tileable2k.xpm
WE ./ruins/Tileable3k.xpm
EA ./ruins/Tileable4k.xpm
F 3000,10 0,0
C 225,30,0
        111111111 1111111111 1111
        1000000001110000011010101
        1011000001110000001111101
        1001000000000000000000001
111111111011000001110000000000001
100000000011000001110111111111111
11110111111111011100000010001
11110111111111011101010010001
11000000110101011100000010001
10000000000000S01100000010001
10000000000000001101010000001
11000001110101011111011110N0111
11110111 1110101 101111010001
11111111 1111111 111111111111