NO ./ruins/Tileable1k.xpm

F      220,100,0 C 225,30,0

SO ./ruins/Tileable2k.xpm
WE ./ruins/Tileable3k.xpm
EA ./ruins/Tileable4k.xpm







1111111111111111111111111
1000000000110000000000001
10110000011100000S0000001
1001000000000000000S00001
11111111101100000111S0001
1000000000110000011101111
1111011111111101110000001
1111011111111101110101001
1100000011010101110000001
1000000000000000110000001
1111111111111111111111111
              
1111111111111111111111111
1000000000000000110101001
1100000111010101111101111
1111111111111111111111111
