NO ./ruins/Tileable1k.xpm
SO ./ruins/Tileable2k.xpm
WE ./ruins/Tileable3k.xpm
EA ./ruins/Tileable4k.xpm
F 220,100,0
C 225,30,0





1111111111111111111111111
1000000000110000000000001
1011000001110000000000001
1001000000000000000000001
1111111110110000011100001
1000000000110000011101111
1111011111111101110000001
1111011111111101110101001
110000001101S101110000001
10000000000000000110000001
1000000000000000110101001
1100000111010101111101111
1111111111111111111111111